BD515555553D13B
A93AD17939696C2
AAAC3A96AA96B96
C6C56847C4696AB
B93FFC3FFFFC3AA
86AFFD6FFFF96C2
ABAFFFFFFFF853A
C2AFFFFFFFFC3AA
96C53FFFFFF96AA
A957AFFFFFFABAA
AA93C1395396AAA
86AA96AA92C3AC6
A96C2D6AAC7C43B
AC53E956A9517C2
C57C5457C47C556

ENTRY=0,0
EXIT=15,15
PATH=
